# Resources from graph.properties
alreadyConnected=Knoten schon verbunden
cancel=Abbrechen
close=Schliessen
collapse-expand=Einklappen/Ausklappen
containsValidationErrors=Enthält Validierungsfehler
done=Fertig
doubleClickOrientation=Doppelklicken um Orientierung zu ändern
error=Fehler
ok=OK
updatingDocument=Aktualisiere Dokument. Bitte warten...
updatingSelection=Aktualisiere Markierung. Bitte warten...
# Custom resources
about=Über
actualSize=Tatsächliche Grösse
add=Hinzufügen
addLayer=Ebene einfügen
addProperty=Eigenschaft einfügen
addToExistingDrawing=In vorhandene Zeichnung einfügen
addWaypoint=Wegpunkt einfügen
advanced=Erweitert
align=Ausrichten
alignment=Ausrichtung
allChangesLost=Alle Änderungen gehen verloren!
angle=Winkel
apply=Anwenden
arrange=Anordnen
arrow=Pfeil
arrows=Pfeile
automatic=Automatisch
autosave=Automatisch Speichern
autosize=Grösse anpassen
background=Hintergrund
backgroundColor=Hintergrundfarbe
basic=Einfach
block=Block
blockquote=Zitat
bold=Fett
borderWidth=Rahmenbreite
borderColor=Rahmenfarbe
bottom=Unten
bottomAlign=Unten
bulletedList=Aufzählungsliste
center=Zentriert
changeOrientation=Orientierung ändern
circle=Kreis
classic=Klassisch
clearDefaultStyle=Standardstyle löschen
clearWaypoints=Wegpunkte löschen
clipart=Clipart
collapse=Einklappen
collapsible=Einklappbar
connect=Verbinden
connection=Verbindung
connectionPoints=Verbindungspunkte
constrainProportions=Proportionen beibehalten
copy=Kopieren
copyConnect=Beim Verbinden kopieren
create=Erstellen
curved=Gebogen
custom=Benutzerdefiniert
cut=Ausschneiden
dashed=Gestrichelt
decreaseIndent=Einzug verringern
delete=Löschen
deleteColumn=Spalte löschen
deleteRow=Zeile löschen
diagram=Diagramm
diamond=Diamant
diamondThin=Diamant (Schmal)
direction=Richtung
distribute=Verteilen
divider=Treelinie
dotted=Punktiert
documentProperties=Dokumenteigenschaften
drawing=Zeichnung{1}
drawingEmpty=Zeichnung ist leer
drawingTooLarge=Zeichnung ist zu gross
duplicate=Duplizieren
east=Ost
edit=Bearbeiten
editData=Daten bearbeiten
editImage=Bild bearbeiten
editLink=Link bearbeiten
editStyle=Style bearbeiten
editTooltip=Tooltip bearbeiten
enterGroup=In Gruppe hinein
enterValue=Wert eingeben
enterName=Namen eingeben
enterPropertyName=Eigenschaftsname eingeben
entityRelation=Entity Relation
exitGroup=Aus Gruppe heraus
expand=Ausklappen
export=Exportieren
file=Datei
fileNotFound=Datei nicht gefunden
filename=Dateiname
fill=Füllen
fillColor=Füllfarbe
fitPage=Ganze Seite
fitPageWidth=Seitenbreite
fitTwoPages=Zwei Seiten
fitWindow=An Fenstergrösse anpassen
flip=Spiegeln
flipH=Horizontal Spiegeln
flipV=Vertikal Spiegeln
font=Schrift
fontFamily=Schriftart
fontColor=Schriftfarbe
fontSize=Schriftgrösse
format=Format
formatPanel=Bereich "Formatieren"
general=Allgemein
formatted=Formatiert
formattedText=Formatierter Text
glass=Glas
global=Global
gradient=Verlauf
gradientColor=Farbe
grid=Gitternetz
group=Gruppieren
guides=Führungslinien
heading=Überschrift
height=Höhe
help=Hilfe
hide=Verstecken
hideIt={1} verstecken
hidden=Versteckt
home=Ursprung
horizontal=Horizontal
horizontalFlow=Horizontaler Fluss
horizontalTree=Horizontaler Baum
html=HTML
image=Bild
images=Bilder
import=Importieren
increaseIndent=Einzug vergrössern
insert=Einfügen
insertColumnBefore=Spalte links einfügen
insertColumnAfter=Spalte rechts einfügen
insertHorizontalRule=Horizontale Linie einfügen
insertImage=Bild einfügen
insertLink=Link einfügen
insertRowBefore=Zeile oberhalb einfügen
insertRowAfter=Zeile unterhalb einfügen
invalidName=Ungültiger Name
invalidOrMissingFile=Ungültige oder fehlende Datei
italic=Kursiv
layer=Ebene
layers=Ebenen
landscape=Querformat
laneColor=Lane-Farbe
layout=Layout
left=Links
leftAlign=Links
line=Linie
lineend=Linienende
linestart=Linienanfang
linewidth=Linienbreite
loading=Wird geladen
lockUnlock=Sperren/Entsperren
manual=Manuell
middle=Mitte
more=Mehr
move=Verschieben
moveSelectionTo=Markierung in {1} einfügen
navigation=Navigation
new=Neu
noColor=Keine Farbe
noFiles=Keine Dateien
none=Keine
normal=Normal
north=Nord
numberedList=Nummerierte Liste
opacity=Deckkraft
open=Öffnen
openArrow=Offen
openFile=Datei öffnen
openLink=Link öffnen
openSupported=Unterstützte Formate sind mit dieser Anwendung erstellte .XML Dateien
openInNewWindow=In neuem Fenster Öffnen
options=Optionen
organic=Organisch
orthogonal=Orthogonal
outline=Übersicht
oval=Oval
pages=Seiten
pageView=Seitenansicht
pageScale=Seitenskalierung
pageSetup=Seite einrichten
paperSize=Papiergrösse
paste=Einfügen
perimeter=Umfang
plain=Einfach
portrait=Hochformat
position=Position
posterPrint=Posterdruck
preview=Vorschau
print=Drucken
radialTree=Radialer Baum
redo=Wiederherstellen
removeFormat=Formatierung entfernen
removeFromGroup=Aus Gruppe entfernen
removeIt={1} entfernen
removeWaypoint=Wegpunkt entfernen
rename=Umbenennen
renameIt={1} umbenennen
replace={1} existiert bereits. Soll die Datei überschrieben werden?
replaceExistingDrawing=Vorhandene Zeichnung ersetzen
reset=Zurücksetzen
right=Rechts
rightAlign=Rechts
rotate=Rotieren
rotation=Rotation
rounded=Abgerundet
save=Speichern
saveAs=Speichern unter
saved=Gespeichert
scrollbars=Scrollbars
selectAll=Alles markieren
selectEdges=Kanten markieren
selectFont=Schriftart wählen
selectVertices=Knoten markieren
setAsDefaultStyle=Als Standardstyle festlegen
shadow=Schatten
shape=Shape
sharp=Eckig
size=Grösse
sourceSpacing=Anfangsabstand
south=Süd
spacing=Abstand
straight=Gerade
strokeColor=Linienfarbe
style=Style
subscript=Tiefgestellt
superscript=Hochgestellt
table=Tabelle
targetSpacing=Endabstand
text=Text
textAlignment=Text Ausrichtung
textOpacity=Text Deckkraft
toBack=Nach hinten
toFront=Nach vorne
tooltips=Tooltips
top=Oben
topAlign=Oben
transparent=Transparent
turn=Drehen
underline=Unterstrichen
undo=Rückgängig
ungroup=Gruppierung aufheben
url=URL
vertical=Vertikal
verticalFlow=Vertikaler Fluss
verticalTree=Vertikaler Baum
view=Ansicht
west=West
width=Breite
wordWrap=Autom. Zeilenumbruch
zoom=Zoom
zoomIn=Hineinzoomen
zoomOut=Herauszoomen
